11111111111
10100000001
10111111101
10000000101
11111110101
10000000102
10111111101
10100000001
30101111101
10001000001
11111111111